{
  "tileSize": 16,
  "layers": {
    "collision": [
      "################",
      "#..............#",
      "#......####....#",
      "#..............#",
      "#....####......#",
      "#..............#",
      "################"
    ]
  }
}
